GGGRGGGGRRM
GGGRGGGGGGM
GGGGGMMGGGM
GGGGGMMGGGG
FFGRGGGFGGG
FFGMGGGFGGG
GGGRGGGGGGF
GGFRGFFGGGF
GGGMGFFGGGF
GGGGGFFGGGG
RRGGGGGGRRG